xxxxxxxxxxxxxxxxxxxxxxxxxx
xGGGGGGGGGGGGGGGGGGGGGGGGx
xGxxxxxxxxxxxxxxxxxxxxxxGx
xGx....................xGx
xGx..xxxx...xxxx..xxx..xGx
xGx..x..x..xx......x...xGx
xGx..xxx...xx......x...xGx
xGx..x..x..xx......x...xGx
xGx..x..x..xx......x...xGx
xGx..xxxx...xxxx..xxx..xGx
x1x....................xGx
xxxxxxxxxxxxxxxxxxxxxxxxGx
xPGGGGGGGGGGGGGGGGGGGGGGGx
xxxxxxxxxxxxxxxxxxxxxxxxxx