..#1.################
..#..#..............#
..#..#.............X#
..#..#..............#
..#.....#############
..#.....#...........#
..#.....#...........#
..#######GGG........#
.........###........#
....................#
....GGG.......GGG....
....###.......###....
.....................
.....................
####################.
