xxxxxxxxxxxxxxxxxxxxxxxxxx
xXGGGGGGGGGX...XGGGGGGGGGx
xXGXXXXXXXGX...XGXXXXXXXGx
xXGXXXXXGGGX...XGXXXXXXXGx
xXGGGGXXGXXXXXXXGXGGGGGGGx
xXXXXGXXGXGGGGGGGXGXXXXXXx
x1GGGGXXGXGXXXXXxXGXXXXXXX
xxxXXXXXGXGGGGGGGXGGGGGGGx
x..XGGGGGXXXXXXXGXXXXXxxGx
xXXXGXXXXXXXXX.XGXxxxxxxGx
xXGGGXXGGGGGGX.XGXGGGGGGGx
xXGXXXXGXXXXGXXXGXGXXXXXXx
xXGGGGGGX..XGGGGGXGGGGGGPx
xxxxxxxxxxxxxxxxxxxxxxxxxx